cyan:1,B
+++++++++++++++++++
+                 +
+aA1           0Bb+
+                 +
+                 +
+++++++++++++++++++
